A	AH
A(2)	EY
AM	AE M
AM(2)	EY EH M
CHECK	CH EH K
CURRENT	K ER AH N T
CURRENT(2)	K ER N T
CURRENT(3)	K AA R AH N T
EMAIL	IY M EY L
FOR	F AO R
FOR(2)	F ER
FOR(3)	F R ER
HEY	HH EY
HISTORY	HH IH S T ER IY
HISTORY(2)	HH IH S T R IY
I	AY
LIGHTS	L AY T S
MUSIC	M Y UW Z IH K
OFF	AO F
ON	AA N
ON(2)	AO N
PLAY	P L EY
SEARCH	S ER CH
SEND	S EH N D
SET	S EH T
TIMER	T AY M ER
TRAFFIC	T R AE F IH K
TURN	T ER N
WEATHER	W EH DH ER
WEB	W EH B
WHERE	W EH R
WHERE(2)	HH W EH R
YOU	Y UW
